-E-o--X|--T|------?----------------TT------|-o-?|o-E--o----|BM-X-B---E-XM-MX-------E------|---T---B-----B------T-----T-o-------B--M--o-XM------MTX--o---o--o---o--|----T---B-------o---------oXB--|-----
----?--o------------o--------M--------?-------------M--T-M|----|--M---M|-------------?|M-----T|o----B----------M-?--o---M--------X--o--E-----o-------?--M-----------------X-------T-X-----------|---oB--
-----X--E-?X-?---ET---------?--XTE-----BE----M----------B-|-------?-T----------?--|-BBT--------o|--?oT---|----?T----X---|T------------M---BT-M--------------XX-------?M---M----------M--Bo-|B---T-E-----
-|-?---------MMo-M---T--M-------E----M--------B|E------------------TMT----B---?M|----?------------Eo-T-E??-M---M-----------------------E------oX----T--o-?-E-o---M-----M-T?-----T----|o---|---B---------
-----X------oTM-X-----??-MX-T--o-E-X-X----M------T-X-E---TB--E---T-M---MM--?oM-----------X--B?------E-------------o--o--o-Eoo?-?--E-------|EM--Mo-TM----------o-------MM---|---E?--|-------?--o----E-?E-
--?----o--B---X-------?---|---------B-------TBT-----------|---|--X--------?-----?--------------|?----X------BT------|--B---------------B---M---?-o---|X-T----M------|----------------------B-X--B---BXo-
-X-B-o--MMT-----B-|--B---------X--|-T-T?--X-o-X---MM--------BE-E-----o--?E---M------?M--E------X----E---MM----EE-E-o----------M----------------M----T-B------E-X----To-B--Bo--?X-----?-----EB-BB--X--?E-
--M--E------?T-----|--o------M--EX------X------X-----T-B--EB--o-------T---o-----|-B----|-------|--B----o---|-B-B----XT-----X--EM---M----E---o?---E-X-B------E-EE-|-?X-|----M--|--B--X|----|----?------|v
---M----?o--T----o------E----|X?-T---?M------|M---X-T--|-T--?-----------E----XB---|------XT-B------T-|--M-------------o--E--B--------TB-----?--BB-----M--o----?----M--EX---------E---E--BE-----E--?--B-f
-M---------?o--EE---M---------T-----TE--o-?-o-----X--o--|--E-----B----X--M------------M-B-|--E------XE|T-MX---E----T-----TE---X-----|E-o--B-MX?-?--?-B-------B|-----M---?-T-|-------------------X---TB-f
-------o--|-E--E-o------oX-------|----------|---?-B-X--M----X-------------M----o----X-?---o------?E-E--?----?-----------MT-oB-------E---------oB-B----EXE--T|B-o|-----T--|--B---B---o----E-------------f
-T-E--E---TE-o--T-------MM|E------|--T|-?-----T-----EM----|Mo---o--M-----EX---o----M-------BX----E-----------M--X-----BM-----E-M----??--------|------o---E-------|------|-E------------------M-----T--Tf
----B-M------------|-----X----o|-M--|------T----o-----T--o--Eo---T---M----?-----M-B---|------o------T---T--------T----X--o?------T-T---------X-------o---|-MT--E------E---B----X-----?X-----M-E-EB----Ef
-T-------X|ET----T---------------------o---|-M--?|----X---?E------------T--X--E----X-T--------B------|?X-----X--------BM-E-----?------||--|----?-----E--------E---B--?---?---E--?-To--?---?o-M-|T--M---f
m?----------B----EMX-M----T--X-B-----------E-------E--------|--?--------BB--E----B----TM-|-X-----o---E------E-B------X--B---MT--E-------E--T-|BEo-B--------MB------B-----E--B-E----X|?----X-----TM-----X
XXXXXXXXXXXXXXXXXXXXXXXXXXXXXXXXXXXXXXXXXXXXXXXXXXXXXXXXXXXXXXXXXXXXXXXXXXXXXXXXXXXXXXXXXXXXXXXXXXXXXXXXXXXXXXXXXXXXXXXXXXXXXXXXXXXXXXXXXXXXXXXXXXXXXXXXXXXXXXXXXXXXXXXXXXXXXXXXXXXXXXXXXXXXXXXXXXXXXXXX
