----------M---------|-----E----|--------------E-M?--------------T-----------------------------T-----B-------------oX-M-----B--------------------------M-----------oX-T---------------------------T----M-
---ME--------E--?-M-----M---?-------------?---------------------|------------------------------oT-------------------------o-----------X-------M--------T--------------------T?---T----------------------
--|--------------------?---------------?-----------------------X--o----X------------------?--o|-------|----------M-------------------------------------------X----X---------|------------------o-|---B--
----T--------?---------Xo------BT---X--T--o-M--?-E-----------T--B------?---o-------E-------------------T------?------------------------X--X------EE---------|---MT------------------------BX------M-BM--
----M--M----B---B----------T?------------?----E----|---|----------------------o----------o----------|------------------------------------------|-X----------------|----------o--------------------M-----
-----------------B-----------------------------------X-E---E-T-----------------?------B---------|--------------|--------TB---EE--------------------------B---E-------M-----B------o---B--------M----o---
-------M--?-o-------o-o?-----------E-?---|B--E-M--------------B-o-------?--?----------X-------|--E-?----------------o------?--------o--------------X-----------------X?------?--o---X------------|------
---------------------M------M-X---M--E----------TX-X---------EB------M--------B---------------------------------------E------------X-------------------------B-?----o--------------|---B---------E-----v
-X----------X-------------E----------o---|---X-------------------X--------------|--B-------?-------------o---------------------------------------E-------B-|o-M--E----B-M----o----EM-----------------E-f
--B---M-------------------------------|-B----------------------X-------------------------?------------T--XB-----E-------------------------------------------?-----X--------?---|--T----E-------|-------f
----------------------X----o----o----X---------------------B--------------E---------------------M-----------EX------------------------------------B-----------------------M---ET-----------|-----E----|f
------E---X-------------M-o----M-------------------------------TT-B----------------E----------------------------------o-----|----------?-----------------------?----o------T----X-------------o--------f
---?--T--------------M--B-X-----?--------|-------------------X--M---M---------------------------------E-----T--E------------|----------E-T-?---------------?------o-----o-----------?-B--|-----------|-f
----T-----?---X--------------o-?--------------B-----X------------------------------------------------------o---------T-----X--M----------o----------M---------M----------B---|-T--E----B---------BX----f
m------X------------------------X-------E--------o-?-------------E---------E------------------------------o-o--------------------T-------|----M----------------T-----M---X-------------T---------------X
XXXXXXXXXXXXXXXXXXXXXXXXXXXXXXXXXXXXXXXXXXXXXXXXXXXXXXXXXXXXXXXXXXXXXXXXXXXXXXXXXXXXXXXXXXXXXXXXXXXXXXXXXXXXXXXXXXXXXXXXXXXXXXXXXXXXXXXXXXXXXXXXXXXXXXXXXXXXXXXXXXXXXXXXXXXXXXXXXXXXXXXXXXXXXXXXXXXXXXXX
