----------M-------E-|----XE----|-----------?--E-M?--------------T--------M----------o---------T-----B---------|---oX-M-----B-----------|-------BT-----T--------T--oX-To---------------------?-?---?-BT--
---ME--------E--?-M-----M---?-------------?---------------------|--------------------------T---oT--|----------------------o-----------X-E-----M--------T--------------------T?---T------------?---B-?MM-
--|X----------T--------?---------------?-------------------EX--X--X----X----------X-------?--o|-------|-B--------M---------|------------------------M--------X----X---------|---------------o--B----|B--
----T--------?---------Xo------BT---X--T--o-M--E-EM-|-?------T--B-----|?---o-------E-------------------T------?------------------------X--X------EE---------|---MT----------------------------?---E-?|E-
----M--M----B-B-B----------T?------------?--X-E----|---|----------------------o----------o?---------|---------------M------?-------------------|-X--o-------------|---------Eo-----------------To---|?T-
-----------------B--o--X-----M-B------X--------------X-E---E-T--------o--------?------B---------|--------------|---M----TB---EE--?--X-----?-----E--------B---E---X---M-----B-----Eo---B---------B---oMB-
-------M--?-o-------o-o?------X----E-?---|B--E-M---M----------B-o-------?--?----------X----E--|--E-M-------------X--o------?--------o--------------X---B-------------X?------?--o---X----------------|M-
---------------------M------M-X---M--E----------TX-o---------EB------ME--o----B---------------------------------------E------------X--------E----------------B-?--|-o--------------|---B---|-EX---E-EoBv
-X----------X-------------E-----B----o---|---X-------------------X--------------|--B-------?------B------o---------------M-|---------------E----oE-------B-|o-M--E----B-M----oo---EM----------------|XXf
--B-?-M-------------------------------|-B-----------|-X--------X-B-----------------T-----?------------T--XB-----|------------T------------------------------?-----X--------?---|--T----E---|--------EEEf
-----o----------------X----o----o----X----X----E-----------B?|------------E---------------------M-----------EX?--------B--------------------------B------------|----------M---ET----------|---o-TT--TEXf
------E---X-------------M-o----M----MX-------------------------TT-B---------|------E----------------------------------o-----|----------?-----------------------?--o-o------T----X--M----------T----M-oXf
---?--T----|---------M--B-X-----?--------|-E----B------------X|-M---M-------------------------------?-E-----T-EE------------|----------E-T-?---------------?--|---o----|o-----------?-B--BMo---T--o-MXTf
----T-----?---X--------------o-?-----B--------B-----X--------T---------------|------B--------------------T-----------T-----X--M----------o?---o-----M---------M----------B---|-T--E----B--|---------oB-f
m------X---|--------------------X-------E--------o-?-------------E---------E------------------------------o-o-----------|--------T-------|----M-------M---o----------M---X---o----B----T-----E------|?|X
XXXXXXXXXXXXXXXXXXXXXXXXXXXXXXXXXXXXXXXXXXXXXXXXXXXXXXXXXXXXXXXXXXXXXXXXXXXXXXXXXXXXXXXXXXXXXXXXXXXXXXXXXXXXXXXXXXXXXXXXXXXXXXXXXXXXXXXXXXXXXXXXXXXXXXXXXXXXXXXXXXXXXXXXXXXXXXXXXXXXXXXXXXXXXXXXXXXXXXXX
