----------M--------?|----oE--M-|-------|-----BE-M?--------------T-----------------------------T---T-B-------------oX-M-----B--|----------------oM--B-------------T------M-E-B-E---------------?---?-BT--
---MEo-------E--?-M-----M---?-------------?---------------------|----------B-------------------oT-------------------------o----M------X-------M|-----oBoT-M--Mo--X--o----?-|M---E----|M-----------B-?MM-
--|-?------------------?--?------------?--------------B--------X--o---oX------------------?--o|-------|----------M----------------------------------------B------B-----XX---E-o---X---oo----o-------|B--
----T--------?---------Xo------BT---X--T--o-M--?-E-----------T--B------?---o-------E---o-------------|-T--|B--?------------------------X--X------T-----B-E----E--E-X----M-X---o---------------?---E-?|E-
-------M----B?--B--T--T----T?------------?----E----|---|----------------------o----------o--o-------|--o-------------------M---------------------X-------T-------------T--X-------M------------To---|?T-
------?----------B---E-----------------------M-|--o--X-E-o-ET------------------?------B---------|---|----------|E-------TB---EE-----------------------X---?B-o--E-o------------B----------------B---oMB-
-------|--?-o-------o-o?----M------E-?---|B--E-M--------------B-|-------?--?----------X-------|--ET?------B--?------o-X----?E--M----o-----------------T-TEX-----E---B----M--M-----------B------------|M-
-----------------M---M------MTX---M--E----------TX-X---------EB--X-T-M---T----B-------------E--------------------B----E------------X---------------?-------------M--o-----o--M--?--?--E----|-EX---E-EoBv
-XT-----|---X-------------E----------o---|---X-------------------X--------------|B-B-------?--------B----o---------------M----------M-----------------?-----------M-?-o----|---------B--------------|XXf
--B---M-------------------------------|-B------X----------E----X-------------------------?------------X--XB--|--E--------------------------------------B--?-------E-o------------o---------|--------EEEf
----------------------X----o----o----X---------------o-----B------------E-M---------------------MT------B---EX--------------------------------------T---B--To--E-B-ET-o-XE-----B-------Xoo|---o--T--TEXf
---B--E---X-M-----------M-o----M---------T------M--M-----------TT-BE--------------TE----------------------------------o-----|----------?-----------------------B------------------------o-----T----M-oXf
---?--T-M-------M----M--B-X?--X-?----?---|-------------------X--M---M------?--------------------------E-----T--E-----T------|-----?----oMT-?-----B------------------?--------------B---o--oo---T----MXTf
----T-----?---X--------------o-?----T---------B-----|--------------T-------------------------|-----------?-o--------XT-----X--M-----T----o-X------E------Xo-X---------T---T---B---T-------|---------oB-f
m------X-------------------o----X-------E--------o-?-------------ET--------E-----T-----E------------------o-o----------------E---T-------|----METo-------|-?X--o-------M----To--X------T-----E------|?|X
XXXXXXXXXXXXXXXXXXXXXXXXXXXXXXXXXXXXXXXXXXXXXXXXXXXXXXXXXXXXXXXXXXXXXXXXXXXXXXXXXXXXXXXXXXXXXXXXXXXXXXXXXXXXXXXXXXXXXXXXXXXXXXXXXXXXXXXXXXXXXXXXXXXXXXXXXXXXXXXXXXXXXXXXXXXXXXXXXXXXXXXXXXXXXXXXXXXXXXXX
