----o----------?-|---M-----T--------|E--TB-o-|-|--MB--------B---------B--T---------X--------E---X--E-------------E-MXT-B---M---B----E----|-o------T---T-|---BE|M-----T--------B----?------------|-|-----
-E---E-||B-o----------X|------------M------B--o--M-------o---------------?-o-----T--??|X---BE-------M--------------T---------------o--------------------?-------------------T-|o----X-----------ME---MB-
-o----oE--?-TB----M--X--------?-----o--------------||-----B|----------?-------o-----o------B--T---------------------X-------M--------?-------M--?-----EX----|----X-----------------T-M-|------Xo------B-
-B----?-----o-M--o------E---X----o-------------------------oE--M-o--M--MB----------o-?--Eo-------|E--------M---------T--------------T--E---T----------M-----B-Bo------------?------?o-----BM----M-------
--ooE-----?-M------|B-o-----|---XMM------M--o-----X---?----M------B---------B-----X-XB-----------?------------------|--|E-E-|-----X---X--|----E--T-------T-------------ME--X--E------------------E------
-------E-------|-----Eo------|---T-----------B?------X----X--T--X----TB---o---?-?------o---------M---|-------X--------B-|-|----------B-----------E-----?E---------X---T-----??---|----------|--o--------
-----B--T-|o----M-B-----------------T-------o-------M--------XM--|---o--X----------|--B----E-E---X--E------M------X-T-----------------|-------------TX-oB---?--------B--|---------B--T--------M---------
--M----|Moo---------------Xo----EX-------T--T|M-E-----X------?E--------E-T-----B-----XE--X-|----------M-----------------------XT-----X--E-----------|---------M---X---|X------X--T--X-B------B|--------v
----------------|oXE------E-------M--X-----|-|-B------?--EM-T-MM---|----E----BX---o--------T-T--o------M--------E-----?-MT---------?-------o--ME---?---|B-?---?--X----B-----T---------X----E-------T-B-f
---|--------T----M---?MB------o---T------------M-EE--X---B------E-----M----------EE--X--E-|--T-------B-T-M---o---E-----?-T----X-------Eo---------oo-E----|---|----o--B---X-------M-B------E------------f
-o--------------X---|---M-----B-----------B-|--EM-----oT--?-E-------------o-B--o---o--M---o----------B?o?------T-------------?---T----o------T--o----TB--EoE--X-B--?---B---oB---M--|-------?-?X--?--ME-f
------B--T----X--E-?---o---o------|------T---------E?-----B-o------M-------B---o?-M--?---o-------------|--X---------M-BoM-----------?-X---------E--------o--B---E---------E--|-----M-----|-------?-----f
--T-------M--?-M------------|---B-M-------T-------X----------------T-M-----------B-o?-|--?--TX------?-----------E?---------------T----B-------T------------M--B-----B--------B---o-----------o---B----Ef
------------o-----X---------B-------X------E-??-------TM---------T---------X--------?---------X--------X-----B--?----?o|-M---T------------|------------|-EB----------B-?-M|-?----X---M----------?----?-f
m-----Mo-B-M-------XB-M??----X----o-M---?X--?---o-?|-----T----??----T----B---BBBB------|B--------o--E-----o--EB--E-T-------B|----|-------------To--E-------M----?--------------E-T-M------|-----TME--?-X
XXXXXXXXXXXXXXXXXXXXXXXXXXXXXXXXXXXXXXXXXXXXXXXXXXXXXXXXXXXXXXXXXXXXXXXXXXXXXXXXXXXXXXXXXXXXXXXXXXXXXXXXXXXXXXXXXXXXXXXXXXXXXXXXXXXXXXXXXXXXXXXXXXXXXXXXXXXXXXXXXXXXXXXXXXXXXXXXXXXXXXXXXXXXXXXXXXXXXXXX
