---T---BM--------X----E-----------------o--|---?------X------M-M-B---E-XM----B----EE----X------E-XT---|-----?-E--B--B--oo---M---B------|--------o-------o--o--M-T-------------X----oEB--|-E-------------
----T--o-------T-------M-----MX----E--?Mo?-------------M-M-----|-B----M--|-------------------?-?-------------M-B---------------------T-oX----o---?---?--M-----------------X--------------|-----------B--
-T------E|-X------M--------------|-E?-----------------X------T------Mo----TX--E--||-?-?------------?-T---M--------------B------X-----M-oX--X----------------?-----------MT----oo---M-------|---X---T----
------------?-----------M-------M----o--|--------?M---E-------|B---BMT----B-|o-M------------|--B-----B---?-M------------|-oM----MX------E----------Eo--------------M-----B?----|o------------T--------E-
-----B----------M----T|?-------E---X-----------------E-||T---|---------M------------|-----T|---B---------------------------oo-----E-?-B-?-|----Xo-------------B-------?---------?----------------??---E-
--|--M--------------------?-------------------E----|---o---------X-------T?-|--------------T------|-T-T--M----|-----|--B-------T-------T---X--------B--B----------o------------------------B------------
-----X---X--|----------------B--o-E-o----------------o?--B--B-B----M-X--?--------X-----M-B-|-------X----M---X-M------------BT----o-----------M-M------X--------X----To?--------------?-----E---------T--
---------oM-?T-------To-M---T------X--------------MM---B--X---------------X------------------?-|-----------X---B-o-|----?----|E--|------X------------------E---E---o-T------EB?-----M--------E----E----v
------M----|----M?---|-------?-T------------------X-T--|-T-o-----------------------X-----X-----X----------Mo------------X---B--------XB-----?-------B|---o--------?---o---T-------?oE-------------?X--Bf
-M------TM--o-o-o-------X--B--T------E----B-X-----|------o--?B---M|------M--o-----B---M------E---B----|----------M|--X---T----??-----o-o-TB--XB--M---------?-------------------B----------|--?o-----?--f
----------|--M--E--------T-----o---------?------B------M----T---o--E-----------------------------?------|----M---------------X----E-E-?-------o|-B----EM-----B--X---------------|--------E-o------?-EM-f
-?-X--T--X--------------------B-------------B-XB-----M---X-?T-T-o---X-|--E|-o-B---TM?-|--E-----|E--TE------o-----------M----|--T-B--B-----------|B---o-MEE-----?---?--|T|-------------------X--------?-f
--BM-EMM------------------------?M---------------------------------o--------E--M--M----------?-T----BM---------------X----?-X-M--T--?-----o--------M-----|--o------------------B---|----|-----EB-E-X--Ef
--|---------|-B-------MM---------B-------o------?|---M?----E----|----------X--E----X-----------------X-|--------M--B---M-------?M--------?---------M-X----X---EB-------o-----------o-?-B--------T------f
m-----------T----E--------?|-------B-------E?X--M----------o-|----------?--M---M|--E-----E--------E---B----------EX---------M------|---XT-M--E-X-------??--------M-----?---------------M-MX--T---|-----X
XXXXXXXXXXXXXXXXXXXXXXXXXXXXXXXXXXXXXXXXXXXXXXXXXXXXXXXXXXXXXXXXXXXXXXXXXXXXXXXXXXXXXXXXXXXXXXXXXXXXXXXXXXXXXXXXXXXXXXXXXXXXXXXXXXXXXXXXXXXXXXXXXXXXXXXXXXXXXXXXXXXXXXXXXXXXXXXXXXXXXXXXXXXXXXXXXXXXXXXX
