---T---|M--|-----XB-M--??---B-----------o--|-o-?-o-E--oM----XT-X-B---EE|M-M---------------oB---o--T---||--|----M----B--oo-------B-M----?--------TE--o---o-Bo----T-------------X----oE-----E----B-X----E-
----T-oo---------T---E-------MX----E--?-o?------B--o?--T---TT--|------M--|----oo--M----M-------?----T-X-------------o--TM--E--T-T---oT-oX----o--M----?------------B-------X---B----B--------?--M-B---M--
-?B-----E|?X---------------------|E-?----o---oM--B----X-B-|-?-----?--M-?--T---E?M---B-T---------o--?-T-B-M---B-T--X-B---B-M--T-X-----M----M--?------------B-Xoo-|----?--|-----oo---?-?-----|B-X----T----
---------X--?X?------|--M-|-X---M----o--|--------------------------BMT----B|To-M-----?------|--B--Mo-B--??-M-----|||oE--|Xo-MME--------XE------X--oE---o-?---oX----MM--M-------|o-----o-o-|--T--------E-
-----M|-T----E--|----|-??-|--T-T---X-----B-----------E-M|B-o-|-----M---MM---E-----T-|-------|B----B-E------------oo-E|-----ooB-?--E-?----M|-|--Xo-------------B-------?o-------E?-M--|MM---?----?B-E--E-
-B---M-o--------T-----?--------|----X------E--T-M--|---oT-----|--B----|--T?-|--------------T----?-|-TXT-BM-B-T--EX--T--B---T-B-o----B-?B---X--|--|X-B-------------o----------T----X-----------o-----|---
----X----M-----T-------E-------X--E--ET-E-----X---M--oT-----B--TT--M-X--?----------------B-|-------X----M---X-o-------X----T?M-M--?--E-oo---EM-M------o------T-X|---To?-----T--------?-----E------X--?--
------B---M-----------o|M----------B--|------------B--XB--X--MB-|-?-B-T---X-----------T------?-|-----------X--T--o---Xo-?--X--E--|-M----T---?-M-----X?-----E---EM--o---M---EE-|--|--M----T|-----E-----|v
------M----------o------M----------oE-M-E-E-------X-T----T----------X--X----X-B---BX--E-?X|-E------T------MoE----------|-E--B--------XB-o-T-?---|---B|---o------T?M---o---T------EXXB--T--------oE?---Bf
-M------TX--o--E----M-M-X--B?-T-E-B--E----B-o-----X---|M---X---X-B|------M--B---E-o-|-M----|XE---B----?--TX--X--B-?--X--XT-----?|--?|--o--Bo-XX-MM-o-----T---------------------B-E|-------|-MoE-----B?-f
----------|-X---E------E-X|---Xo----X----?------?--|---M-----M----------BB------------?--E-------?---?X--X---MM------|-------X----EoE-?-------oB-T----EM---BMB-oX-----TT------?--?-------E--?-----M-X--f
-?----T--E---------T--------------E-----?-----TE----o----X-?T-X-|---X----E|-o---|-T-?-o--E------E--TEX----------T------M-X---o---T--B?----T----------o-M-E?----?-|----|T-----E------T-----TT-M-----T--Mf
--oT-XMM-------M----X-----------?-------------XE-E--?-|--E--E----o-o-----------Mo-MM---------o-T----T-----------E----XXX-o?--|---T--?--?o|o------o-------B--T--E----------ME--------?MX-|-----EB--oM-?|f
-TX-B----?-E|-BX-----TE-|--------B--------Xo|--------M?----E------------T--X--E-M--Xo-------------E--XTXE----X--M-----BMBBT--o-?--M----|-X----------------X|-XEB--B-X----B---E-----E-T?---------T-|-M-Mf
m---EoT---E-B--------XB---M|------E--------E?X?-M--o-------o-|----MB----?--M---M---X-----|-----T--E-|---o-----E---?-M-------M--?--------T----ETX--E?---o-?-------M-|---X----B------X-?----XBT-----?----X
XXXXXXXXXXXXXXXXXXXXXXXXXXXXXXXXXXXXXXXXXXXXXXXXXXXXXXXXXXXXXXXXXXXXXXXXXXXXXXXXXXXXXXXXXXXXXXXXXXXXXXXXXXXXXXXXXXXXXXXXXXXXXXXXXXXXXXXXXXXXXXXXXXXXXXXXXXXXXXXXXXXXXXXXXXXXXXXXXXXXXXXXXXXXXXXXXXXXXXXX
