----o----------?-|---M-----T--------|----B-o-|----MB--------B--?------B--T----|----X--|---------X--T--------E----E-M-?-B---B---B----E------o----------T-|---BE|M-----BE-------B-----X----?--o--?|-B-----
-E---E-|Eo------------X|------------M--X--EM--o--Mo------M-M-X---o---------------T--??MX---B|----------------------T-?--E-X-----E--o-----------------E--?-------------T-----?--o----XB----------B|---MB-
-o--|-oE--?-TB----M?-X--------?-----o--------------E|TM--EB|--EE-----|?--?----|-----o---M--B--T---------T--------B--?-------M--------?-------M--?---?TEX----|----X-----------------T-M-|------X-------B-
-|----?-----o-M------o--E---XE---o-o-------------|---------XE--M-o-BM--MB--------T-o-?--Eo-------|E------------B-----TT-------------TX-E---T----------M-----B-Bo---------B--?----B-?o-----BM---EM-----|-
--oMT-----?-Mo-----|B-o-----|----oM?-----M--o---------?--E---XE---B---------B-----X-XBM--------X-?---|----o---------|--|E-E----o--X---X--|--B-Bo-T-----o-T---------|---ME--X--E--B--------T------E----o-
---o---E-------|T-?--Eo--B---|---T-T----E--X-B?------X----Xo-T--X----TB---o--|?-?------o---------M---|-----?-X-------EB-|-|----------------------EB--|--E-----?--MX--BTo--XM?---E|----------|--o-E------
--------T-|o----M-------------------T-------?-------Mo-----B--M--|-|-o--X----------|o-B-B--------XE-E---M---------X-T-------------|---|---------E---TX-o----?-----M---M-|---------B|-T-----?--M----B-X--
--M-?--|M|oM--oB----o-----Xo-?---X---?---M--T|M-E-----X-----X?E--------E-o-----B-----XE|X?-|---------o-XX----M-E----?---------XT---E?X--E---------X-|T--------T---X---|X------X--T--X-B---o--B?--------v
---B-------B----|?--------E----------X|----|----------?--EM-T-MM---|----E-T---X---M--------T-T--o------M--------E----|?MM--o-M-----?----------EE---?---|B-?----------XB---------X-M----------------T-B-f
---|--------M-?--M--E?MB-----Eo--?---?---------M-EE--X-T-B--X---E-----M----------EE--X--E----T-------B---M---o---E---o-?-T----X-------To----E----oo-E-?-B----|-o?----B---X-------M-B------E------------f
-o-------T----|-X---|---M-----B---------T-E----EM-----oT--?BE-----------|To-B--oE--o--M---oTT--------B?-?-B----T-------------?---T----o-E----T-------TB--MoE--X-BX-?----o--o-B--M-----B----?-?X--?---E-f
------B-MT----X--E-|---o---o--M---|-MT---T--Xo-----??-----B-o-M---EM----T--B---o?-M--?------------------B-T---E--ME---BoM------?----?-X---------EX--B----o--B---E---X-----E--B-----E-----|----?--?-----f
--T----------E-M---X---M--EX|---B-MM------T-------X-------------B--T-E-----------B-??-|--?---X------?-----------E?--E------------T---BB-------T------------M--B-----B--------B---o---------B-o---B----Ef
-o----------o-----X---?-----B-------X------E-?---E----|M---E--E-?|--------?XM-------?---------X-------XX-----B--?----?-----?-T----------E-|-------o----|-EB--oB------E-?-M|-?----X---M-----|E-T-?----?-f
m-----Mo-B-M------oXB-M------X-B--o-M---?XE-?---o-?|E----T----??----T----B-B-oBBB------|B--E-----o--E-----o--EB--E-T-------B|----|--M-----|M---To--E------|------o-------------o-T-M-?----|--E--T-E----X
XXXXXXXXXXXXXXXXXXXXXXXXXXXXXXXXXXXXXXXXXXXXXXXXXXXXXXXXXXXXXXXXXXXXXXXXXXXXXXXXXXXXXXXXXXXXXXXXXXXXXXXXXXXXXXXXXXXXXXXXXXXXXXXXXXXXXXXXXXXXXXXXXXXXXXXXXXXXXXXXXXXXXXXXXXXXXXXXXXXXXXXXXXXXXXXXXXXXXXXX
