----------M---------|-----E----|--------B-----E-M?---B-M--------T-------------------X---------TB----?-----M-------oX-M-----B-B------------------------B----T--X---oX-T----------------------------|EBT--
---ME--------E-E?-M-----M---?-----B-------?-X--X-|---------T----|-----E-E--------X------X------oT------M------------------o-----------X-------M--------T--------------------T?---T------E-----------?MM-
--|M--------------|----E---------------?|-----------M----------X--o----X------------------X--o|-------|----------M-------------------------------------------X----X----E----|------------------o--M-|BB-
----T--------?---------Xo-----|BT---X--T--o-M--?-E-----------T--B------?---o-------E-----------------M-T------?------------------------X--X------EE--B------|---MT--------M--------T------BX------E-?|E-
----M--M----B---B----------T----To-X-----?o---E----|---|----------------------X----------o----------|-----M-----B------E-----------------E-----|-X----------------|----------o|-------------------o-|?T-
--E--------------B-----------------------?-------------|---E-T-----------------?------B---------|--------------|--------TB?--EET-----o--E----------------B---E-------M-----B------o---B------o-M----ooB-
-------M--?-o-------o-o?-----------B-?---|B--?-M--------------B-o---?---|--?----------X-------|--E-?-B--------------o------?--------o--------------X-T------o--------X?------?--o---X-------------X--TM-
---------------M-----M------M-X---M--E----------TX-X---------EB------M--------B--B------------------------------------E------------X-X-----------------------B-?----o------------B-|---B----------E-EoBv
-X----------X-------------E----------o-X-|---X-------------------X---B----------|--B--M--?-?-------------o---------------------------------------E-------B-|o-M--E--E-BXM----o----EM--|-------------|Tof
--B---M-------------------------------|-B----------------------X---------|--------M------?------------T--XB-----E------------------------------------o------?-----X--------?---|M-T----E-------|-|o-oEEf
----------------------X--T-o----o----X---------------------B--------------E-o------B------------M-----------EX----------------------------B-------BX----------M-----X-----M---ET-----------|--|--T-TT?Xf
------E---X--------B----M-o----M-------------------------?-----TX-B----------------E--B-----------EB---B--------------o-----|----------?-----------------------|T---o------T----X-------------o--ooMEo|f
---?--T-T------|-----M--B-X-----?--------|-------------------X--M--BM---------B---------------------E-E-----T--E---o--------|----------o-T-?---------------?------o-----o-----------?-B--|----------MXof
----T-----?---X-----|-------oo-?-T------------B-----X-----------------------X------------------------------o---------T-----X--M----------oX---X-----M-------B-M--------T-B---|-T-XE----B---------X--oB-f
m-----XX--T--------M------------X-------E--B-E---o-?X------------E---------E------T--------------M-X------o-o---------------M----T-------|----M----------------T-----M---X---o---------T------------|-|X
XXXXXXXXXXXXXXXXXXXXXXXXXXXXXXXXXXXXXXXXXXXXXXXXXXXXXXXXXXXXXXXXXXXXXXXXXXXXXXXXXXXXXXXXXXXXXXXXXXXXXXXXXXXXXXXXXXXXXXXXXXXXXXXXXXXXXXXXXXXXXXXXXXXXXXXXXXXXXXXXXXXXXXXXXXXXXXXXXXXXXXXXXXXXXXXXXXXXXXXX
