----o----------?-|E--M-X---T--------|----B-o------MB--T-?---B---------B--T-------E-X--|----|----X-TT-------------E-M-?-B---B---B----E------o----------T-|B--BE|M-----BE-?-----B-----X--|----|--?--|-----
-E---E-||o----X-------X|------------B----oEM-----Mo------M---X--M--o--------o----T--??MX---X|----------E-X---------T----E-X-Eo----Xo-T-XB------------E-M?-M-----------T-----?--o?---X-----------BE---MB-
----||o---?-TB-------X--------?-----o--------------E|----EB|---E-----|?--o----|-----o-M-M--B--?---X-----------------X-----------E----?-----T-M--?-----EX----|----X-----------------T-M-|-----?--------B-
-|----------o-M------o--E----E-M-o---------------|----------E--M-o--MM-ME----------M-|-XEo------?|E------o---------------------M----TX-E---T----------|-----B-Bo----|---T---?-------o------M---MM-----|-
--oMT-T---?-ME-----|BE-M----?-----T---------o---------?------Xo-E-B------M--B----TX-XBM--------X-B-B-|----o---------|--|E-E---T---X---X--|----B--T---T-|-T---------|---X---X-----B---------------E----o-
---o---E--B----|T----Eo------|---T------E--X-B?------X----X--T--o----TB---------?------o--------T----|-------X--------B-|------------------X?B---E---|--E-----?--MX--BTo--X-?--oE|----------|-oo--------
--------T-|oo---M-B------------X----T-o-----?----o--M------E--M--|---o--X----------|o-B------E---XE-E---M---------X-T----------B---X--|---------E---TXXo----?-----M---?-|-------M-B|-T--------M-XM---X--
--M-?---M|oM--oE----o-----Xo-?---X---?---M--T|M-------X------?E--------E-T-----B----B-E-XXX|---------oMX-----MM-------------T-MT---E?X--E---o-----X-|T-----B--X---X---|X------X--T--X-B-------?--------v
------B----B----|-----------------M--T-----|------B|-----EM-T-MM---|----MMT---X---M--B-----T-T--o---------------E----|?MM--o-M-----T----------EE---o------?-----------B---------X----------EB----o-T-B-f
---?--------T----M--ETMB-----Eo--?---?---------?-EEo|X-TXB------EE--o-M---T---|--EE--X--E----T----X--B---M---o---E-----?oT----X-X----|To----E----ooXE-?E-|E--|-o?--------X--X----M-B------E------------f
-o--------------X---T---M-----Xo-------oT-B----EM-----oT--?BE----------E|-o-B--o---o--MM--oT---------B?-?-B----T----------B--?--------o------T-------T---EoE----BX-E----o--o-B--M-----M----?-?X--?---E-f
------B--T----X----?X---?--oM-M---|-M---o-|--o-----??-----B-?------M----T-MBX--oX-M--?-|------------------X---E-------B-M------?------X-------X-EX-------o--B------T----T-E-||---------o-|-------?-----f
--T----------E-M---X-----XE-|-----------o-T-----------?---|------B-E-M-----------B-o?-|--?---X-----T?T-?--------E?---------o--?--T----B-------T------------M-----------------B---B-----------o---B----Ef
-o----------o-----X---------B----E--X------E-?-------T|M---------|--------?X--------o---------XE------XX----XB--?---T?-----?-T--------X-|-----M-|-o--o-|-E-T-oB------B-?-Mo-?----XB--M---X-|E-T-?----?-f
m--oB-Mo---M------oXB-M------X----o-M-?T?-E-----o-?|-----T-----B----T----B-BooBBB-----T|B--------o|-E-----o--E---E-T-------B--------M-----|-----o--E------o------o-------------E-T-E-?---M|-----T-E----X
XXXXXXXXXXXXXXXXXXXXXXXXXXXXXXXXXXXXXXXXXXXXXXXXXXXXXXXXXXXXXXXXXXXXXXXXXXXXXXXXXXXXXXXXXXXXXXXXXXXXXXXXXXXXXXXXXXXXXXXXXXXXXXXXXXXXXXXXXXXXXXXXXXXXXXXXXXXXXXXXXXXXXXXXXXXXXXXXXXXXXXXXXXXXXXXXXXXXXXXX
