----o------------X----E--o-T--------|---oB-o--Mo--M---X-----BM-M-B----BX-T---------E--|-X--|---E-XT-----------E--B-MB?-BoM-B-E------E------o----o-----T-|-----|M--------?-----o-----EX--|-E-|-E?--------
-E--TE-o-o----X-------X|-----M----?E|--Moo---------------M---X-|-B-o-----|-----------?MX---E|?---------E-X---MXB---T----E-X-Eo----X--T-XB--|-----??--?-MM-M-----------------?--o---------------------BB-
-T--||--E---TB-------------------|--o---------|-----|-X------o-E-----|----TE-o|--|--o-o----B--?----?----------------------------E----?-----X-M--B-B---E-----?------M----M---M-o----|---|-----?-----T----
-|B---------o--------o--M-------------T-|--------??---E--------M---BMT-M--B-|------M-|----------?|E------o-M-----|------|T-M-----X-----EEo------------X-------B------|---B-----|o------------T-MM-----|-
--oMT-T-------------BT|?----------TX-----------------EE-|T---Xo----------M----------X-----T|---X-BM--|----|---------|--|E-Eoo-----X---X-?--------T---T-|--M---B----|---X-?-X----?-------o--------E?---E-
--|XM-----B-----T-----o--------------------X--?----|---o--X----------T-------------?----------------T|---M----|-------BB|------T--E----T---X?----E---|--------?---X--M-o----?--oB--------M-B-E----------
--M--X---X|o|---M------------MMXo---T-o----------o--M---------B------X--?----|-----------B?--T---XE-E---M---------X-T----------B-o--M-|----E-M-ME---TXXo---------TM-To?-----------E|-T-----E--M--M---T--
----?|---Eo-?-oEM-----o-M-XoT?-T---o-----M---|oB--MM----------E-B---------X---------B-E-XXX|---|-----oM----X---B-?------?---T-E----E?---X---o-----M-|------E--ME---o-T----B--BX--T--M------?-E?----X---v
------B---TB----|----|---------T------------------X----|-EM----M----------T---X----X-B---X-T-T-XX-?-------M-----------?-X---BM-----T--------?-------B|------------?---B-X-------X--o-------EB----o-T---f
--------T---o--M-M--ETM-M----ET------B----B-X--?-E|------o--?B--EM--o----MT---|---T-?X--EE-|-E---o-----?-M-------E------oT----??-----oTo-TB-E----M-----E--E--|-----------X-o-----M|B------E|-?o--------f
-o--------|-----X--------T-----o-------o-?-----EB------M---BT---o--E------o----o-------M---T-----?----?-|-B-----M---------X--?---|-E--?-------o--B-----M--oE-B--B------------B--|--------E-o-?X------M-f
---X--B--X----------X-?----o|-MT--------o-|-B-X----??M-----?T-T-o-------T-|BX-Bo--TMB--|-E---------TE-----Xo--E------|---T--|--T-B--B-X---------|B---o-M-o---------T---TT-E--|---------o-|-------------f
--T--EMM-----|-M---X-----XX---------------T----------BE-----?------o-o------E--M-B-----------X-T---TBT--------E-E----X----?o--?|-T-----------------M-----|-Mo------------------B---|----|-----X--B-X--Ef
-o|----?----o-B---X--------------E-------o-E-?-------M|----E-----X---------X--EB---Xo------------B-E-X-|-----B--ME-XT?-M---?-T--M-----X---------|-oM-o-|-E----E--------?----?-----B--M-B------T-T------f
m---B-M----M------T-B-M--|T||-----oB----B-E-----M|-----B-T---|-B?--------B-Mo--M|--E--T--o-------TE--------------EX--------B------------T-|--E------o--X?--------o-----?-------E---------M|--T--T|-----X
XXXXXXXXXXXXXXXXXXXXXXXXXXXXXXXXXXXXXXXXXXXXXXXXXXXXXXXXXXXXXXXXXXXXXXXXXXXXXXXXXXXXXXXXXXXXXXXXXXXXXXXXXXXXXXXXXXXXXXXXXXXXXXXXXXXXXXXXXXXXXXXXXXXXXXXXXXXXXXXXXXXXXXXXXXXXXXXXXXXXXXXXXXXXXXXXXXXXXXXX
