---o|-??-MBX-M---ME-|M---?E----|--------------E-M?------------o-T--------------------------E--TE----B-------?-----oE-M---M-B-----------|-------BT-----T------E-T--oX-To---------------------?-?---?-Bo--
----|-?--E------o-M-----M---?-------------?-------B-----------E-|-------T----------------------o|-------------------------o-----B-----X-E-----M--------T--------------------T?---T------------?---B-?MM-
---M|-E----------------?-|------M------?----E------------------X--o----X-------T----------?--o|-------|----------M--MB-B----------------------------M--------X----X---------|T-----E--------o--B----|B--
----X?--X---X----------Xo---X--MXXo-X--T--o-M--?-E-----|-----T--B------?---o-------E---------------T---T------?----?-------------------X--X------EE---------|---MT----------------------------?---E-E|E-
---E----B--Eo-T-o------X---T?-------Mo-T-?----EX-?o|---|------TT------MT--o---o----------MB---------|M-----|-------X---------------------------|-X--o----B--------|E--------Eo-----------------To---|?T-
----|??----|-X---o-------------------------------X---X-E---E-T----------M-?--T-?------B--M------|--------o-?---|-------EXB---EE-oB--X-----?-----E--------o---E---X---M-----T-----Eo--oB-----B---B-T-oMB-
-----------B--X-|-o-o--?------?----E-?B-X|B--E-Xo-------BM----B-o-T----Eo--?----------X-------|--E-?------B----o----o-B----?M-------o--------------X---B-------------X?------?--o---X----------------|M-
--MB---X-?-ME--------M-?----M-X---M--E----------TX-X---------EB---E--M--------B-|-----o---------------?|---------T----E-----B------X--T-----E---------------To-?--|-o-o------------|---X---|-EX---E-|oBv
---M--------|-------------E-o--------o---|---X-------------------X-------?------|--B-------?T----?-------o-----------------------------T---E----oE-------B-|o-M--E----B-M----oo---EM-----M----X-----|XXf
-----------?|Xo---|-----------------|-o-B-------X---------E----X-----------------B-------?M-----------T--XB-----E-------------------------------------------?-----X--------?---|-MT---EE-?-|--------EEEf
-----X---B---E--?-----X----o----oX--oX---------------------B--------------E----------?----------M-----------|X------------------------------------B----------?-|----------M---ET----------|---|-TT--TEXf
-M------|--B----M--B----M-o----M----Xo------o---------o--ET----TT-B----------------E---------X----------------------B-o-----|-----B----?-------------------M---?--o-o------T----X--M------T---T----M-oXf
-------|T----------E-M-EB-M-----?--------|-------------B-----X--M-?-M-------------X-------------------E-----T--E------------|----------E-T-?---------------?--T---o----|o---E-------?-B--BMo---T--oEMXTf
---?---o-------?T------------oM?--------------B-----X----------------o-------------X----------------------oo---|-----T----?X--M----------o?--?o-----M---------M-----E----B-M-|?T--E----B--|-----B---oB-f
m-M--T-M-M-----o----------------X-o--?--E-----|--o-B--B---T---B--E--?------E?-----------------------------o-o--------------------T-------|----M-------M---o----------M---X---o----B----T-----EM-----|?|X
XXXXXXXXXXXXXXXXXXXXXXXXXXXXXXXXXXXXXXXXXXXXXXXXXXXXXXXXXXXXXXXXXXXXXXXXXXXXXXXXXXXXXXXXXXXXXXXXXXXXXXXXXXXXXXXXXXXXXXXXXXXXXXXXXXXXXXXXXXXXXXXXXXXXXXXXXXXXXXXXXXXXXXXXXXXXXXXXXXXXXXXXXXXXXXXXXXXXXXXX
