--T--T-----E------------------?-----------|---?----------?ETX--------X--------M------E-X----------------M--|-M---|--?----------?o----------------------X---E---X-------B----X---------o--------?-----T--
--T----X------o-----?|--M--------------------------?----?o----------E--B---B-------------------------E-B-------------------------------------?----Eo---EM----M--------X------------------X-o--------?MM-
---?Bo--T---------o-------o-----E-T---|-----?T---B--|----E-----------TT----------------T--------------B---------M-T--?---------|---T--|------------B-------?-B-X-?Bo------X--|------------------E-X-|X--
---o-----------?-|---E-M----------oM-------T---------------------------------M-------o-E-------|--?-----o-----------------B-o-----B-------E--?o--------------T---------BX-------X----?E---o---------?XE-
----------?-----B-?-B---|---?-----------o------|---------------------------------E-----------------------------------------X--M-----------E-T---M---|----------------------------------------M------|?|-
--T|-------B-----------------?--M--B------|----B-X----|---E---E-?-----------M--?E--T----M--o-T-------------T----------X----------------------X--M--X------------------X-----------oM------------|---oMB-
--E-----?-T---------------M-------E---------------------------E|---------------------------B----T-T--------------|B-----?----------M-------------T------------------------T---T-----E-B------?-------TM-
-------------E---M-----------E--------X---B---------------------T--------B---------------X--E---?---------X-----?-B---------------oT-----------------X-----E----------?----------?|---E---M----X--M-EoBv
----E--------B-X?--------|X----------E--MBB-X-------|--------------------------------------M--o----?------?|-M-------------E-B--X-------------|-X----o--------M---X----------TM---------------------Bo?f
----oo----??--ME|----B---------T-M-------o------------EE----|------o--E--------T-M------X--------------T------------|------B|--Xo?-----------------M---------M-----------------o----X-----o---------oEEf
-----------o-E---|-B------------------|X----o--E---------Mo--o-B---------X-------------------------T-------B----o-?--------------------X----X------X------?-M---o-|------oB---M----------B----------TEXf
--?-T---E-M----?------------?|---------o--------|---------M------------------------?---------M-------|-------------o------------------------E-------?------X------?------T---M-|------|----T---X-----BXf
--TX---M------?-ETM--o-B----------E----E---M------------|----T------o-----|-|----T---------B-?T------?--------------------------------|-------------------o-----B----M-EM-------------------E-------METf
---|--T-------------B--T--X---B-------------TM--------------T---B-X---------T------?---------oM-------o-------------|---------------B----------------B-|B------E---------T------------X-----E-------oB-f
m--o-?---?----X-----------------------B----o-XX|-------?--------E-------M----|------------o-----E---oM---------T?B-------B---?----M---X--M-----------------------E-----E-?-------?-------M-------EM-|o|X
XXXXXXXXXXXXXXXXXXXXXXXXXXXXXXXXXXXXXXXXXXXXXXXXXXXXXXXXXXXXXXXXXXXXXXXXXXXXXXXXXXXXXXXXXXXXXXXXXXXXXXXXXXXXXXXXXXXXXXXXXXXXXXXXXXXXXXXXXXXXXXXXXXXXXXXXXXXXXXXXXXXXXXXXXXXXXXXXXXXXXXXXXXXXXXXXXXXXXXXX
