-X---|X--X-|------?oB-T--------oB---MT-TE----oB?|M----o----B-M---------E--M----X---E----E-----T----o--------X-X--BX-XT--------BB-----------E-------------M---E---XB----------------o-------X--X--M|-----
-B?---M-----M-------o----o----M-M-|--|X--B-o----------XT-M-----?--M---M?--o--?----o--??--------M-E----------E--M---Eo------X----o----?-E-M-o--?---E--E---o------------|---|----o|-M-X------------M-M-BM-
-----XX-----------T----E------E-TB------X-?--M-X---T-----------|-E--T-M---E----?M---B----|-T-o-B-|-?-o-oB----?X|----------------------M---|-X----B-TB--o--------------------------o----o|--MX--E------E-
-----?M----??-M--M-B----M----------M---B---|--X--X--M---------T--MT-----X-Mo---M--------------M----B-?--E--B------------------|-TT---------BM----|-------?----------|-o--T?E--B|o---B|--o-TX----BB---X--
----|------T-----X----------TM-o---|Xo---------------E----B-|--X-XM---TM----X---o-o------------Bo-B---oX-------T-----|T-o-M--B--------B---?EB-X?oo-o----------oo----------------BoM------TE?o--------?E-
-TM----o-B----|-X--E----?|---?M-----?----o--T-T----E----|M|--M|--X|-----?-?----------X---?-------X---X-ET|---M--M--?--||----T--|-----MMB--o---B-Mo-M-|-B-----M?X----|------|--?-X----X-----B------T--|--
-X------MM-X|---o----B-B--X---|------X-?---||-------o-------X--------T-B-o-TB--?|--Bo-EB--oM---X------E-----T-E--ETXM---M?---E---M----E-|E--E-MMBo-TT----------XB---ToB-|--oX--X------o---M-E--Bo---??--
-B|-Eo-X----BT-------E----E----BMX-X--o----M-----------BE-E------X----------o-----T--------T---|o-BBT--------B-------?-M?--X-T-M---MX-|--B-------T-T--------E-EE---?X-EE---M--|-----X------T------?-E--v
-E-M----?-o-TX---M------E----M-BX-E-----X---B||---X--o--ET--?------|-?--EX--------T---T--oT--|-----o--?E---------?------X|--M|M-B-----------?--BE-----E?-T-------|M-|-EE|-?----?o-----------------?-EB-f
--------|----T--E--X-----------B----X----T?-o----M---o-EoE--E---------T---------|E--B-----MT-E------|--o------E-X-----B--E----------ET--|-EM|-Xo?M--?X-?-----X|-----M-oM?-T-?--o-?---------X--|-----TB-f
---------------?----B---o?|---o--BE--------?----B-o----M--------------M---|--|?-----------o---------E--?B----T-?---?B-B-M--------X--E-|----XX-?|-|-----XM?T-|Xoo|-o--?X?---B-------------E--XB-------TMf
---------M---o---XE-B---MX------XT-------o--M---X----M---X?Mo-------B-?---M-----BoE--------------E-TE---XT---M--X------M-----?--XM--??---?----|-E----o|o---?-B-----B-EB-M|E|--|------MB?------M--?-T---f
-o--B----T-------oME|o--------E|-M--?---M-------E------M---??oT----------o---XX-M--?---------?B--X---|X-T---o----T---TX------X------B----------|-----T---|--E--E---M-XM--------X-----?M---------|---|X-f
-----o----TTT-E--T----T---E--|--To-----o---------B----X--------o|---?---|----------X|TE-------?-?X--------T------M-------M-?----oM--X|-|---T---?B------o------B---B----------Bo--ETo---------M-|--TM--Tf
m-------?---B-E--?B--?------E----E-----E---E--X-----o------T---o--------?--|-o---BT--X-M-----|----TM------------|-------XM-X-T--M----E------X|B--------o---MB------X---o-E-E|--------??--?M------o----XX
XXXXXXXXXXXXXXXXXXXXXXXXXXXXXXXXXXXXXXXXXXXXXXXXXXXXXXXXXXXXXXXXXXXXXXXXXXXXXXXXXXXXXXXXXXXXXXXXXXXXXXXXXXXXXXXXXXXXXXXXXXXXXXXXXXXXXXXXXXXXXXXXXXXXXXXXXXXXXXXXXXXXXXXXXXXXXXXXXXXXXXXXXXXXXXXXXXXXXXXX
