---o|--?-MBX-M----E-|-----E----|--------------E-M?--------------T--------------------------E--T-----B-------?-----oE-M---M-B--------------------------M---|------Eo--T--------o------------------T----M-
----|-?--E------o-M-----M---?-------------?-------------------E-|-------T----------------------o|-------------------------o-----------?--E----M--------T------------------?-X?---T----------------------
---M--E----------------?-|------M------?-----------------------X--o----X-------|----------?--o|-------|----------M---B-B------------M---------------------|--X----X--|-X----|------------------o-|---B--
----X?--X---X----------Xo------BT-o-X--T--o-M--?-E-----------T--B------?---o-------E---------------T---T------?----?-------------------X--X------EE---------|---MT------------------------BX------M-BM--
--------B---B---E------X---T?-------Mo-T-?----EX-?-|---|------TT----------o---o----------M----------|M-----|-----------------------T-----------|XX----------------|-X--------o--------------------M-----
----|??----|-X---o-----------------------------------X-E---E-T------------?----?------B---------|--------o-?---|-------EXB---EE-------------M----------o-B---E-------M-----B------o---B--------M?---o---
--------------X-|-o-o--?------?----E-?B--|B--E-Xo--------M----B-o-T-----?--?----------X-------|--E-?-----------o----o------?--------o-----T--------X--------X----?---X?------?--o---X----------T-|------
--MB---X-?--E--------M------M-X---M--E----------TX-X---------EB------M--------B-|-----o-------------------------------E-----B------X-------------------------B-?----o--------------|X--B---------E-----v
---M----------------------E----------o---|---X-------------------X-------?------|--B-------?-----?-------o---------------------------------------E-------B-|M-M--E----B-M----|----EM-----------------E-f
-----------B|-o---------------------|-|-B-------X--------------X-----------------B-------?------------T--XB-----E-----------------------------o--?----------?---o-X---o----?---|--T----E------M|-------f
-----X---B---E--?-----X----o----o----X---------------------B--------------E----------?----------M-----------|X--------------------oo--------------B------B----------------M---ET-----------|-----E----|f
-M---------B----M--B----M-o----M----X-------o---------o---T----TT-B----------------E--------------------------------B-o-----|--------X-?-----------------------?----o------T----X---------|---o--------f
-------|T----------E-M--B-M-----?--------|-------------------X--M-?-M---------------------------------E-----T--E------------|----------E-T-?M---|----------?------o---E-?-----------?-B-X|-----------|-f
---?---o-------?-------------oM?--------------B-----X----------------o-------------X-----------------------o---------T-----X--M--E-----E-o----------M---------MB---------B---|MT--E----B---------BX---|f
m-M----M-M-----o----------------X-------E-----|--o-?------T------E--?------E------------------------------o-o--------------------TB------|----M----------------T-----M---X-------------TMB-------------X
XXXXXXXXXXXXXXXXXXXXXXXXXXXXXXXXXXXXXXXXXXXXXXXXXXXXXXXXXXXXXXXXXXXXXXXXXXXXXXXXXXXXXXXXXXXXXXXXXXXXXXXXXXXXXXXXXXXXXXXXXXXXXXXXXXXXXXXXXXXXXXXXXXXXXXXXXXXXXXXXXXXXXXXXXXXXXXXXXXXXXXXXXXXXXXXXXXXXXXXX
