----|----MB--M-----------------------E|---?---T--------|---X---T----M---X--------------X-------|-------------M------oE|---E-?ET-----T-------X-----E--EM--------o------------o----------E----?-?---o-BT--
------?------------------M---M-B------oE-E------------------B-----X---T-----B--------M-----X----------o----?------?----E--------M-----------T--E---B---Bo-M------o------------o-------o------T----X-|MM-
---M------o------------|-?---XT---------------XT-----------------------T---o-----------------------------------M--T--X-X-----------------------------E-E------------------------B-X---------X---T---?B--
---?X?--X--TM--------------------------|---M------M---T------B------------------M-o-------------------------B----E----M-B-o-----E-M---------M--E----------------E|----------|---M--------E-----B--E-M|E-
--------B---B---E--M--------------X--MM--T-----------T-------------X-E-----|-E--|--o-----E--oB-T--------------------X-------E---------X-------?---------------T-BB-|--E----EB---M---oB--|----ME-----BXT-
----|-?----|-----o-|o-?----o?X-|---X---o--o--------|---------||---M---o-?----Mo-----?-----|-------------M-----o--------T?--T----ME------E-----------------|-----Eo---T-----|-----------------?--?-M-oMB-
-------------------------------------------------M-|-------T---|------|----------X--------T---------?-----------B-----------Mo-T---E----T-----o---T|---------------M-B---------------------------E---TM-
-X-B---X-?X-E----------------M----B-MBM----------------E----ET------------T-------?X-----E------------|------------B----?------M----?----?--------X---|oT---E-BT------ET-T-----o--------B-M--EX---EEooBv
---M-----------X---o--E--|-E------------T-X-M----X------------|--M-----------?-------E----------E-|--M---------TT-----B----T------?----B-|------T----------------B----T----X-------------B--------X-|oof
-X-M-B-----B--o-------------To---?-----------o--------|------X---B----M---T-------EB-E--------------o---------?-----------E-X--------------T----------------|-------|B-------Xo-------?------------|oEEf
---------B---E--?-------E---E--o-----M-----X--B------------T-E-o----------T---------?----------X------E------E--M-EEE-----------?---X----o-----?----E------o-o-----o--------T------B-------o--o-----TEXf
-M---------B----M-------MM---E-M------M--|----T------------o------M---|-o---------------------------?-----?-M------o---------------X--?---o------o---X?----E-?---X---|----M---M---------------T-----EoXf
-X----|-X-----------------TX---X------?-T--------B------------?------T--------------------X------T------------TX---------|--M----M--TE--X-----B--B--|--B---------------------T--------E--?B---------MXTf
-------o-------o-----X--o------T------E-M-M--M--------E--------?---o-------------E--------|------B--------?------|--?------------------------|-----|--------B------B--M-B-----------XT-------?------oB-f
m-M------M---B----?M?------E----B|-B----T--------M-o---E-M-------?------XB---X----M----?-----M--|------TE-B---M---?----|---|---?--E--EEE-B--------o?----E----------M----o------------o|------?X--oX-|?|X
XXXXXXXXXXXXXXXXXXXXXXXXXXXXXXXXXXXXXXXXXXXXXXXXXXXXXXXXXXXXXXXXXXXXXXXXXXXXXXXXXXXXXXXXXXXXXXXXXXXXXXXXXXXXXXXXXXXXXXXXXXXXXXXXXXXXXXXXXXXXXXXXXXXXXXXXXXXXXXXXXXXXXXXXXXXXXXXXXXXXXXXXXXXXXXXXXXXXXXXX
