-----------B-------?-------------------E----E---|-XX--------------M----------------------|---------T--?--?---------o-----E-M-----?X--------?-------X---|---------M--o------------To----T-----B-MM-------
-M-?-------X--------X------B--M-?----BM------------E--T-X-----|---o-------MX----------------o-------M-----------------------XM-------------T--B-------M-----------------------------EM-M----o---------M-
-----|---------|----------M?------|-----?---B----------X-----------T------M-----B-------X---o-------|--------TE----|-------|-B-TXX|-----o-------?------|M-----------------------M----------|-------?----
------T------?M----------?-----|-B--T-------oT-----------E--|--E--MB-B--B-?------T----?---E------------------X--E------E-----?---o------B---------BT----?--E-----T-----|--?-------?--X------------B?-EE-
---------E--M-----------o--E---B--X---------------------------B-----?--E--M-T------|-----|----MM---o--B---|E-----X-------o--T-T--E-------B--|-----TT-----E-----T------T----E-----E?-o-?-----X---------T-
-----X----X------------ET------BB----------ET-----T----B--X----B--B-----------|-----E----X--T---M--o------------------------E-----------X----M-o--|---|---E---------B-----|-B-M|--------------|-o-----E-
----------o----------------T---------M------E-X------------XM----------------------BM---B-------TX---M-----------?-BB--?--------|---------M---M-E---E---------?----------o------------E|-M--E---M-o---M-
------------------X--X--------E---------------T-------||----T-M-------?B---------B-----B-?----?--------?--B---------M----E--o--|-M-|-------|-----M---------------T-------------o------M---T-T|-|EX----Bv
--------------X-----B--T------?---B--E-------------E----X------?E------E-X----B---M--------------------?------E-T---T----------------E-----?-?E---o-------?------|---M------------------E-----?T----o-of
-B----------E--?-----?----|---------E-----o--M-----------BX-----T--------M-E-M-----------|--|-X-------o---X--M--o--B--MX-------------------o-----------------M-M------|E-?------?---B--M|-|-----E----TEf
----X------|T-E--M-----M-----------------------B-E----?----EB---X--------------o-X----M---o----------------------o-----T-B-----E-T----------------XT-T--o-----E-----------?--M--------------EM--------Xf
-------|----------X-----------M----------X---E-E-T-----T--X----|--|------M--B----------X-------------X------------|?----|---B--M-----E---------|---?----------E------?----------------B--E------|E-M--Xf
-E-E-------------oo|--o-------|-------------E-------BX---------------o----------|-----------------?----?----T-----------o-----------------------X----------------------------?------o--|---|-XT-M--o--Tf
---------M---?-------?M-X-T---X--M------?------T------------X----T------------E-B-----o-----M------------X-?------o---M---oBE----X--------B----X-?----?----------------------------EB----M-T--E---o---?f
m---B---M-------------------------o|--T-E|-----M---M-----B---------------?---------?----?-----|--o-EB--------?----o-?--|---------------XE------E-------------------E---------o-------B-M--|----Moo----|X
XXXXXXXXXXXXXXXXXXXXXXXXXXXXXXXXXXXXXXXXXXXXXXXXXXXXXXXXXXXXXXXXXXXXXXXXXXXXXXXXXXXXXXXXXXXXXXXXXXXXXXXXXXXXXXXXXXXXXXXXXXXXXXXXXXXXXXXXXXXXXXXXXXXXXXXXXXXXXXXXXXXXXXXXXXXXXXXXXXXXXXXXXXXXXXXXXXXXXXXX
