-----B---o-------T-------T-M--?---M---M--E---------------M----T---?---X---------o------B----------o-------TE----?-----E----o--------------------------------|-------o--------M?---M---M-X---o---T|---M--
---E-|---------?---o-M-------X--|-T------?------Bo---B--B-------------M--------------------X-TT----E----?----o----------X---?-X|-----B-M-------o--T---?-E--------B--------T------BB-MB-----------B-T----
---------|oT--?-T--M---E-To?--|---T--M-------B----------|------------?-----X----------M|---X------M---X-M------------o----E----------------M-T-?X--------------X-----?|-o-B------------?T---------------
-----B---T-------------M-----E-----M----B---E----------------|-TM--B--------o--------B--------B--M---T-X--o--o-----To---E-B-----BM--------T-----------M----o---?--?-----B--------E----------X|--B-------
--B---------?-o--M-|B--o--E------|------E-----------X-|?-------B------E-B-o----?T-----E---B?--M------------o----B---Mo--E-----------------------o-------X--M-E---------------------X--T---T?-----T-T----
--T----T------------------E-----T--E---|-?---------E---M--XE-|--T------MM-T-----?-oE--T-----M-------M------|------E---------------------------------|--------------M--M-M-----?-----------|----T-----Mo-
----B------||----M--------X-M---M--?----|----B------o------M?---------?----X---------X-?-----------o-?--|-M---ME---------?-E------B--o----T|--B-------E-?-------------M--o--X-----o------?---M----------
----X-TE-----T--------?---T----o-E|-----------------?---------B-M?-BB?-|--B---------------------------X----------|--X-|--------E-E-----?-o?--------M----?-----oE--ET|?-----o-X--|--X-------|---E-------v
--TME--|-----T-M|-M-----TB---EX-oT-------------T-----?-----?------EMM--T--M-----------M--------------|----o--------|-T--o-|E------------M--?---o--------M--B---|--------Xo-|--------E-----X----E-XoE--Mf
---ET---X---?--------T---M------------------E-----XX-E------------o-|------o----------------B---E--B------?o?---Eo----E-------------------|--------------|o-----?--|-B-Bo----|--o-M-------o-----------?f
--M-X-----TM---M|------E?-X-?------E---|-o---------M----T---------B--------------------M?----E-B---?------------?T--|-------TE--------M-o-T-----BE-----T---E-T----E--------B?-----|---|------o-----o---f
------|----?---------B-----|----M-X-----------B--------T-o-|--X--T------?--?------------o-M-X----------?|-----?-----------|----MX-o-------------E-oMT---------M-T----o----B--E-----------?M-T----EB-T--f
---B-|--T---TT-|--|-B---B--B-----M-----|M-----------X--E---------X?-T----TTT--------?-----|---M---?--------?--|--------?-o---------o-------B|--M------------M------EX-T-B--?--------TX-|----X-E--------f
---|-?--EE----T|---o----------------BX-----X------B----o----------B------TB------B?o------T----E-T----?T---BX----oE--T?-----------E-----B-B---------?|--M-----B-|T-?-----------------------------E--M|-f
m-T--M--X--|-----X-?------E-----?-------E---|--------------------T------------?--------B--E?T-----M-----T----X----o---|---------T--?---------EM--M--------o---B---------T-E-----?XX----------B-----T---X
XXXXXXXXXXXXXXXXXXXXXXXXXXXXXXXXXXXXXXXXXXXXXXXXXXXXXXXXXXXXXXXXXXXXXXXXXXXXXXXXXXXXXXXXXXXXXXXXXXXXXXXXXXXXXXXXXXXXXXXXXXXXXXXXXXXXXXXXXXXXXXXXXXXXXXXXXXXXXXXXXXXXXXXXXXXXXXXXXXXXXXXXXXXXXXXXXXXXXXXX
