---To--EM--o-----B---ME-----X-o-E-E-T--oo--?---?---o--XM-----M-M--T--E-XMB---E--|-E|------X---TE--T---|-M---?|Eo-BoE-T-o----BXX-E-M--o-X-----E--M----M--o|-o-----?o-----M-----X--B-o-B--|-----T--?o-E---
-------?-------T---M---M-o---MXE---E--?Mo--o----------TM-o-----|-BM------|o-------B---------E--?---TB--------M-B-?-------------?---XEo-o---M-o----------M-----X-----M-B--------------o---|----M-M----B--
-T---------E------M--------T-----|-E?-|------B----o||--------T----E-|o-X-T----E---T-?-M------o-----?|E------------------B------X----------oX-----------X-----?---X-------T---------M---|---|oB-o---T--o-
------------??E--------|M---M---M----o--|-----X-------E-------|BM--BTTBM---E-o-M------E-----|?|o---E---E-T-?---M-----T----?M--|-B---------M|--oX------T|------B----M-M----?----------------?----E-------
----?B------?---M--X--|?----T--|X--X--------------|-?-?-|----|---------M-X--------X-|-M---To---BX-|M-E---E|--T-M-----o------|-----BTM-B-M-|----Xo--------X----o-------?T--------M----------------T?-----
---B-M-----------?--?--B-||---------B--------------|-M-o--|-T----X---T----o-|---?-------------B--E--T|T--M---B|-----M--oB---X--T---E---|--EX-------|M--B----TB----o------|--?--M----|-|-----|--XBB--o|--
-o---X---X|--B--------E--EX---------o-----T-----?-?--------MBE-----MoX--T-------TXT------B-|-------X-------X--M---------B--------o----------M--M---oE-Xo-------XX----o---------------?-----?--?---------
-X--X-|--oo--T-------T--B--o-------Xo------------E-----B--XBT------X------X----BE---o-------------B--------X--|B-o----------o|E--|------E-X--?--------X----E--ME---o--|X--B--XX|----M---------|-E-Eo---v
-|-M--M--o-|-M--BM--||-E-----?X------XB-----|-----XM--?|-T--T-M-----------M--B-E--oX-----XET---X----------M----o--B-----XX--B---E---EX-----B-E----EBB|----?---?---E---oM--T|----|-T-EE-------o--T-MXBBBf
---------M--o-o-o-E-E------X--T-M---T-----B-X--MM-|-----T---?----M---?---M--------B-------M--o--E---?-|TB-------|M-----B-T--T-??--o----o-----XB|-MX--------M---?-----?--?-EX---B-?-----o-Xo-oTo-X--B?T-f
-X--------|--M--------E--T-?---|---------T------------oM----T---X--E-T|-----Bo------B?-X?-----o--?------|----M-----|----B----M--B-----o-------o|-B-----E-------oB--------------------------o-B----?--M-f
-?-X|-T--X--|-B------------oM-------------?EB--B-E--E----X-?-MT-M-TMT-|---|-o-----E-?X--oE-----|?--XB--B?--o-B--|-?----M----|T------BB-B----|----Bo-To-ME------?E-E?|--T|-E---------------M-----E?-|-?Tf
--BT-EEM--TE--M-B-----------|-o--M---|----|---------TB---M------o--o------?-E--MB|B-------o---------B-------T---E|---X|---?-X---MT-T--B------------------|--o---------------E--X---|----o-E------E-X--Ef
--|---|------T-X------M--------|-B--X--------E--?----M-----E-----o|---B--?-|----Bo-?T---M-----B---TT?T-|-----EM-?-----oM-----?-?----------M--T-?X--X-----EX---o--T--T--o--|--------o-M-|--M-----o----XBf
mM---M--------?--X--E-------|-B-----M---M--E-X--M-----------------T-----?--M?---X--E----BE-?------T---BE-----TE--EX--X------o--X----X--X?-|T-E------oB----?----------------------T-----M|MXX-TE--|---?-X
XXXXXXXXXXXXXXXXXXXXXXXXXXXXXXXXXXXXXXXXXXXXXXXXXXXXXXXXXXXXXXXXXXXXXXXXXXXXXXXXXXXXXXXXXXXXXXXXXXXXXXXXXXXXXXXXXXXXXXXXXXXXXXXXXXXXXXXXXXXXXXXXXXXXXXXXXXXXXXXXXXXXXXXXXXXXXXXXXXXXXXXXXXXXXXXXXXXXXXXX
