-?--------o---------|M--?-E----||---?-----o---E-M?--------|-TB--T---T-------------------------T--BE-B-------------oX-M---o-B-----------X--------------M---------E-oX-T----T----T-------------B------BT--
---ME-?------E-M?-M-----M---?------?-----TEE--------o-----------|-----------B---------------T--oT-----|-M-------------?o--M-----------X-------M---ET-MTT---------?--------?-T?---T------------------?MM-
--|M----X------o----X-|?----B-------X--?-------M---------|-----X--o----X-------?-------M--?---|------T|---------oM-------------------------------------------X----X--B------|----------o-------o----|B--
----T------|-?---------Xo-|----BT---X--M--o-M--?-E------?---MT--B-B----?---o?----M-E------------o------T--E---?------------------------X-TXTX----EE-B-------|---MT----------X------------?BX--T---E-?|E-
--?-M-Xo----B---B|---------o?---------X--?----E----|-Xo||-----------------|---o--E|-E----o----------|---------M------------------X-------------|-X----------X---E-|----------o---?-X--M-------------|?T-
-----E----------XB-----------------------------------X-E---TET--X------|------|?---M--B---------|--------------|------B-TX---EE-----M---X----------------B---E-------M---T-B---?--o---B-----?--M----oMB-
-----o-M--?-o--M-B--o-o?-----------E---B-|B--E-MM--|----------B-o-------?--?-----B----X-------|E-E-?----------T------------?----E---o--------------X-E-------------E-X?------?--o---X---T---------X--TM-
-?--E----------------M------?-X---M--E--------?-TX-X---E-----EB------M--E-----BTB----M--------------------------|-----E-------|----X--------E----------------B-?----o-----|------|-|---B-------E--E-EoBv
-X-----o----XME-----T---o-E----------o-------XE------|-----------XT--?------E-M-|E-B-------?---X-|---o---o------------o-------------M----------M-E-------B?|o-M--E----B-M----o----EM----------------|oof
--T---?-------------------------|-?---|-B----E-M--------B------X-------M-----------------?-----------oT--XB-----EE---------------------|---T----------------?-----X-X------?---|--T----E-------|----oEEf
--?M------X------?----X----o----o----X-------------X--o----B----------M--|E---------------------M-----------EX-----------------------------?------B----------T--E---------M---ET-----------|--------TEXf
------E---X-------------M-o----M-------------------------B-----TT-B---T----B----M--E-------------?---?-------T-B|-----o-M---|T-------?-?-----o----------|--|---T----T------T----X-------------o---o--o|f
-X-?--T--------------M--B-X----B?--------|----B--------------X--M---M--------------------X--------X-X-E-----T--E----|----T--|---------?E-T-?--------------o?------X-----o-------M---?-B--|----------MXTf
----T--B--?---X--------------o----------------B-----X-----M---?-----|-E--?---BT------------E-----------T---o---?-----T-----X--M-----T----o----------M---|-E-T-M----------B---|-T--E--|-B-B----------oB-f
m------X-----------M--|---------X---M--TE-Mo-|---E-?---T--------|E---------E-------------BM------E-----T--o-o--------------------B-------|----M-----------o-B--T-----M---X-----|-------T---X--------|?|X
XXXXXXXXXXXXXXXXXXXXXXXXXXXXXXXXXXXXXXXXXXXXXXXXXXXXXXXXXXXXXXXXXXXXXXXXXXXXXXXXXXXXXXXXXXXXXXXXXXXXXXXXXXXXXXXXXXXXXXXXXXXXXXXXXXXXXXXXXXXXXXXXXXXXXXXXXXXXXXXXXXXXXXXXXXXXXXXXXXXXXXXXXXXXXXXXXXXXXXXX
